111111111111111111111111
000000000110001100010000
010000011000011000000000
100000000000011000000000
100000000000010000100000
120000000000000001100000
000000000000000003000000
000000000000000033002000
011111111111111111111011
011111111111111111111111
111111100000000011111111
111111111111111111111111
111111111001111111111111