000000000000
010000000000
000000000000
000000000000
100000000011
111111111111