00000000000000
00000000001000
00000000000000
00000000010000
00010000110000
11111111111111