100000000000000000000001
100000000000000000000001
100000300030003000300001
100000000000000000000001
100000000000000000000001
100000000000000000000001
100000000000000000000001
100000000070002000074001
166600000000000000066661
111155555555555555511111
111111111111111111111111
111111111111111111111111
111111111111111111111111