111111111111111111111111
100000000000000000000001
100000000300000000000001
100000800000007000000001
100000000666666020000001
100000300000000060000001
100000000000000610000001
10p000000000006110004001
166666666666661116666661
111111111111111111111111
111111111111111111111111
111111111111111111111111
111111111111111111111111