111111111111111111111111
100000000000000030000001
100080000000300000000001
100000003000000000000001
100003000000000000000001
100000000000000000074001
100000000000000000066661
100000000000000000011111
100000000070002000011111
166600000000000000011111
111155555555555555511111
111111111111111111111111
111111111111111111111111