111111111111111111111111
100000000000000000000001
100000000000080000000001
100080000000000000000001
100000000000000000800001
100000000000000000000001
100000000000000000000001
100000070007000200004001
166660066006600600666661
111110000000000000111111
111110000000000000111111
111115555555555555111111
111111111111111111111111