111111111111111111111111
100000000000000000000001
100000000000000000072001
100000000000009000000001
100000000000000000000001
100000000000066000000001
1p0000000000611000000001
100000000006111000000001
166666666661111000040001
111111111111111666666661
111111111111111111111111
111111111111111111111111
111111111111111111111111