111111111111111111111111
100000000000000300000001
100080000000300000000001
100000000300000000000001
100000300000000000000001
100000000000000000074001
100000000000200000066661
100000000000000000011111
10p000000070000000011111
166600000000000000011111
111155555555555555511111
111111111111111111111111
111111111111111111111111