111111111111111111111111
100000000000000000000001
100000000000000000000001
100000000000000000000001
100000000000000000000401
100000000007002000076661
10p000080008000800061111
166660000000000000611111
100000000500000000111111
100500055150005505111111
155155511115551151111111
111111111111111111111111
111111111111111111111111