111111111111111111111111
100000000000000000000001
100000000000000000000001
100000000000000000000001
100000000000000000000401
100000000007002000076661
166660008000800080061001
100000000000000000000001
100000000000000000000001
100000000000000000000001
155555555555555555555551
111111111111111111111111
111111111111111111111111