111111111111111111111111
100000000000000000000001
100000000000000000000001
100000000000000000000001
100000000000000000000001
100000000007200000007401
166660008000800080006661
100000000000000000000001
100000000000000000000001
100000000000000000000001
155555555555555555555551
111111111111111111111111
111111111111111111111111