111111111111111111111111
100000000000000000000001
100000000000000000002001
100030000000009000000001
100000000000000000000001
100000000000011000000001
100000000000111000000001
100000000001111000000001
111111111111111000040001
111111111111111111111111
111111111111111111111111
111111111111111111111111
111111111111111111111111