111111111111111111111111
100000000000000000000001
100000000000000000000001
100000000000000000000001
100000000000000000000001
100000000000000000000001
100000000002000000000001
100000000000000000004001
111111111100011111111111
111111111100011111111111
111111111100011111111111
111111111155511111111111
111111111111111111111111