111111111111111111111111
100000000000000000000001
100000000000000000000001
100080000000080000000001
100000000000000000800001
100000000000000000000001
100000070007000000000001
10p060000006600000000401
166610066000000200666661
111110000000000600111111
111110000000000000111111
111115555555555555111111
111111111111111111111111