111111111111111111111111
100000000000000000000001
100000000000000000000001
100000000000000000000001
100000000000000020000001
100000000000000010000001
100000000000000110000001
100000000000001110004001
111111111111111111111111
111111111111111111111111
111111111111111111111111
111111111111111111111111
111111111111111111111111