111111111111111111111111
100000000000000000000001
100000000000000000000001
100000000000000000000001
166600066666666666666661
111100011111111111111111
111100011111111111111111
100000000000000000000001
100000000000000000000001
100000002000700007004001
166666666666666666666661
111111111111111111111111
111111111111111111111111