111111111111111111111111
1000000!00000000000!0001
100000000000000000000001
100000000000!00000000001
1000!0000000000000000001
100000000000000000000001
100000000000000000000001
100000000000000000000001
100000000000002000000001
100000000000000000000401
111111111111111111111111
111111111111111111111111
111111111111111111111111