111111111111111111111111
100000000000000000000001
100000000000000000000001
100000000000000000000001
100000000000000000000001
100000000000000000000001
100000000002000000000001
100000000000000000004001
166660006000600600666661
111110000000000000111111
111110000000000000111111
111115555555555555111111
111111111111111111111111