111111111111111111111111
100000000000000000000001
100000000000000000000001
100400000000000000004001
106660000000000000066601
10020006600p006600020001
100666000666660006660001
100000000111110000000001
100000000111110000000001
100000000111110000000001
100000000111110000000001
155555555111115555555551
111111111111111111111111

111111111111111111111111
100000000000000000000001
100000000300000000000001
100000000000000000000001
100000800111111020000001
100000300000000010000001
100000000000000110000001
100000000000001110004001
111111111111111111111111
111111111111111111111111
111111111111111111111111
111111111111111111111111
111111111111111111111111