111111111111111111111111
100000000000000000000001
100000000000000000000001
100400000000000000004001
106660000000000000066601
100200660000000066020001
10066000000p000000660001
100000000666660000000001
100000006111116000000001
100000001111111000000001
100000001111111000000001
100000001111111000000001
111111111111111111111111