100000000000000000000001
100000000000000000000001
100000300030003000300001
100000000000000000000001
100000000000000000000001
100000000000000000000001
100000000000000000000001
100000000000000000000001
100000000000000000000001
100000000000002000004001
111100000000000000011111
111155555555555555511111
111111111111111111111111