111111111111111111111111
100000000000000300000001
100080000000300000000001
100000000300000000000001
100000300000000000000001
100000000000700000700401
100000000000200000666661
100000000000000000111111
10p000000000000000111111
166600000000000000111111
111155555555555555111111
111111111111111111111111
111111111111111111111111