111111111111111111111111
100000000000000000000001
100000000000000000000001
104000000000000000004001
166600000000000000066601
1000000ff00000ff00000001
100000f00f0p0f00f0000001
1000f0000066600000f00001
1f0000000011100000000f01
10f02000001110000020f001
100fff000]111]000fff0001
155555555111115555555551
111111111111111111111111