111111111111111111111111
1000000!0000!000!00!0001
10000000000000!000000001
100000000!00000000000001
1000!0000000000000000001
100000000000000000000001
100000000000000000000001
100000000000000000000001
100000000000000000000001
100000000002000000000401
111111111111111111111111
111111111111111111111111
111111111111111111111111