111111111111111111111111
100000000000000000000001
100000000200000000000001
100000000000000000000401
100001111111111111111111
110000000000000000000001
111000000000000000000001
111111111111111111100001
100000000000000000000011
100000000000000000000111
111111111111111111111111
111111111111111111111111
111111111111111111111111