111111111111111111111111
100000000000000000000001
100000000000000000000001
100000000000000000000001
100000000000000000000001
100000000000000000000001
100000000000000000000001
100000000000002000004001
166666666666666666666661
111111111111111111111111
111111111111111111111111
111111111111111111111111
111111111111111111111111